MAXBUBBLE:35
10111133446
20113343666
10111166666
20113343666
10111143446
20114433442
10151133441
20155533446
60151143666
66156666666
66111143666
60115543446
10111133441
20112233442
66156666666
66111143666
60115543446
10111133441
20112233442
