MAXBUBBLE:35
00112233445
00112233468
00111111468
23155553468
23155553425
23133333425
23112233445
23111111445
00155553412
25155553412
25133333412
25112233412
25112233400
00112233400
66133311366
66166611366
66166611366
66112211366