MAXBUBBLE:40
00112233445
00112233468
00111111468
23155553468
23123523425
23123523425
23123523445
23123521445
00123523412
25123523412
25123523412
25123523412
25123523400
00112233400
66133311366
66166611366
66166611366
66112211366