MAXBUBBLE:40
11112233411
22112233422
11112233411
22112233422
11112233411
22112233422
11112233411
22166663422
11166663411
22166663422
11112233411
22661223622
11661223611
22661223622
22112233422
11112233411
22112233422
