MAXBUBBLE:35
10111133441
20112243442
10111143441
20112243442
10111143441
20112233442
10111143441
20112233442
10151133441
20152233442
10151133441
20152233442
10111133441
20112233442
10111133441
20112233442
   51133
   52233
   11133
   12233
   11133
   12233