MAXBUBBLE:35
10111133441
20112243442
10111143441
20112243442
10111143441
20112233442
10151133441
20166663442
10166663441
20152233442
1011166441
20112233442
10111133441
20112233442
51166441201
52266442101
11133441201
12233442101
1663346601
12233442101
		