MAXBUBBLE:35
10111133441
20112243442
10111143441
20112243442
10111143441
20112233442
10151133441
20166663442
10166663441
20152233442
10111664416
20112233442
10222222441
20222222442
51222222201
52222222101
11133441201
12233442101
16633466016
12233442101
		