MAXBUBBLE:35
23112233423
02312233445
23112233423
02312233445
23112233423
02312233445
23112233423
02312233445
11111111111
02312233445
23112233423
02312233445
22222222222
23112233423
02312233445
66112233666
33333333333
66312233666
66112233666
55555555555
66312233666
