MODE 2
SIZE 11/70
LIMIT 0/31
COLOR LIMIT 5
STARS 1200/7500/16000
POWERUPS 1/0/1/1
7 7 11 7 7 12 7 7 14 7 7
7 7 7 7 7 7 7 7 7 7 7
7 7 7 7 7 7 7 7 7 7 7
1 7 7 2 7 7 7 7 7 7 7
1 7 7 2 7 7 7 4 4 7 7
1 1 2 2 2 7 7 4 7 7 7
17 17 1 17 17 2 17 17 4 17 17
17 1 17 17 2 17 17 4 17 17 17
17 17 1 17 17 2 17 17 4 17 17
7 7 1 7 2 18 7 4 18 7 7
7 7 1 7 7 2 7 7 4 7 7
1 1 2 2 2 7 7 7 4 4 4
7 7 7 7 7 7 7 7 7 7 7
7 7 7 7 7 7 7 7 7 7 7
18 18 18 18 18 18 18 18 18 18 18
7 7 4 7 7 7 7 7 7 7 7
7 7 7 4 7 7 7 7 7 7 7
7 7 4 7 7 1 1 1 2 2 2
18 18 4 18 18 1 18 18 2 18 18
18 4 18 18 1 18 18 2 18 18 18
18 18 4 18 18 1 18 18 2 18 18
4 4 7 1 1 1 2 2 2 7 7
7 7 7 7 7 7 7 7 7 7 7
7 7 7 7 7 7 7 1 7 7 7
7 7 7 2 2 4 7 1 7 2 7
7 17 2 17 4 17 1 17 2 17 7
7 17 2 17 4 17 1 17 2 17 7
17 2 17 4 17 1 17 2 17 7 7
2 2 7 4 4 1 1 1 1 1 1